:intro
00000000000000000000
A000AC000000B00D000D
A000AC00000B0B0D00D0
A000AC0000B000BD0D00
A000AC0000B000BDD000
A000AC0000BBBBBD0D00
0A0A0C0000B000BD00D0
00A00CCCCCB000BD000D
00000000000000000000
V0000000000000000000
00000000000000000000
11111111121111111111

:golem
11111111111111111111
10000000000000000001
1000AAAAAAAAAAAA0001
10000000000000000001
10000000000000000001
1V0000AAAAAAAA000001
10000000000000000001
10000000000000000001
10000000AAAA00000001
10000000000000000002
10000000000000000001
11111111111111111111

:krone
11111111111111111111
10000000000000000001
10000000000000000001
100000A0A0A0A0000001
100000B0B0B0B0000001
100000BBBBBBB0000001
100000BBBBBBB0000001
100000BBBBBBB0000001
10000001111100000001
100V0000000000000001
10000000000000000001
11111111121111111111

:mydlo
11111111111111111111
10000000000000000001
100A0000010000000001
10AAA00001000C0C0001
10ABA0000100C0C0C001
10AAA00001000C0C0001
100A00000200C0C0C001
1000000001000C0C0001
10000000010000000001
100V0000010000000001
10000000010000000001
11111111111111111111

:leden
11111111121111111111
10A0A0A0A0A0A0A0A001
10000000000000000001
10000000000000000001
10000000000000000001
1V0000000D0000000001
10000000DDD000000001
1000000DDBDD00000001
100100DDB1BDD0010001
10010DDBD1DBDD010001
1001DDBDDDDDBDD10001
11111111111111111111